1111111111111
1000000000001
1010001000111
100101N000101
1010000000101
1111111111111