1111111111111
1000000000001
1010000000111
1001000N00101
1010000000101
1111111111111